64
0:0:0:0:0:0:0:0:0:0:0:0:0:0:0:0:0:0:0:0:0:0:0:0:0:0:0:0:0:0:0:0:0:0:0:0:0:0:0:0:0:0:0:0:0:0:0:0:0:0:0:0:0:0:0:0:0:0:0:0:0:0:0:0
0:0:0:0:0:0:0:0:0:0:0:0:0:0:0:0:0:0:0:0:0:0:0:0:0:0:0:0:0:0:0:0:0:0:0:0:0:0:0:0:0:0:0:0:0:0:0:0:0:0:0:0:0:0:0:0:0:0:0:0:0:0:0:0
0:0:0:0:0:0:0:0:0:0:0:0:0:0:0:0:0:0:0:0:0:0:0:0:0:0:0:0:0:0:0:0:0:0:0:0:0:0:0:0:0:0:0:0:0:0:0:0:0:0:0:0:0:0:0:0:0:0:0:0:0:0:0:0
0:0:0:0:0:0:0:0:0:0:0:0:0:0:0:0:0:0:0:0:0:0:0:0:0:0:0:0:0:0:0:0:0:0:0:0:0:0:0:0:0:0:0:0:0:0:0:0:0:0:0:0:0:0:0:0:0:0:0:0:0:0:0:0
0:0:0:0:0:0:0:0:0:0:0:0:0:0:0:0:0:0:0:0:0:0:0:0:0:0:0:0:0:0:0:0:0:0:0:0:0:0:0:0:0:0:0:0:0:0:0:0:0:0:0:0:0:0:0:0:0:0:0:0:0:0:0:0
0:0:0:0:0:0:0:0:0:0:0:0:0:0:0:0:0:0:0:0:0:0:0:0:0:0:0:0:0:0:0:0:0:0:0:0:0:0:0:0:0:0:0:0:0:0:0:0:0:0:0:0:0:0:0:0:0:0:0:0:0:0:0:0
0:0:1:4:6:10:11:10:10:11:10:10:11:10:10:11:10:10:11:10:10:11:10:0:0:0:0:0:10:11:10:10:11:10:10:11:10:10:11:10:10:11:10:10:11:10:10:11:10:10:11:10:10:11:10:10:11:10:8:2:0:0:0:0
0:0:0:1:4:6:10:9:10:11:10:9:10:10:10:9:10:10:9:10:10:10:9:10:10:0:0:0:0:0:9:10:10:10:9:10:10:10:9:10:10:10:9:10:10:10:9:10:10:10:11:10:10:11:10:10:11:10:7:3:0:0:0:0
0:0:0:0:4:7:8:10:8:7:6:10:11:10:10:10:11:10:10:11:10:10:10:11:10:0:0:0:0:0:10:11:10:10:10:11:10:10:10:11:10:10:10:11:10:10:10:11:10:10:11:10:10:11:10:10:11:10:7:5:0:0:0:0
0:0:0:0:4:7:8:10:8:7:6:0:0:0:0:0:0:0:0:0:0:0:0:0:0:0:0:0:0:0:0:0:0:0:0:0:0:0:0:0:0:0:0:0:0:0:0:0:0:0:0:0:0:6:8:10:10:11:8:6:0:0:0:0
0:0:0:0:4:7:8:10:8:7:6:0:0:0:0:0:0:0:0:0:0:0:0:0:0:0:0:0:0:0:0:0:0:0:0:0:0:0:0:0:0:0:0:0:0:0:0:0:0:0:0:0:0:6:8:10:10:11:8:6:0:0:0:0
0:0:0:0:4:7:8:10:8:7:6:0:0:0:0:0:0:0:0:0:0:0:0:0:0:0:0:0:0:0:0:0:0:0:0:0:0:0:0:0:0:0:0:0:0:0:0:0:0:0:0:0:0:6:8:10:10:11:8:6:0:0:0:0
0:0:0:0:4:7:8:10:8:7:6:0:0:0:0:0:0:0:0:0:0:0:0:0:0:0:0:0:0:0:0:0:0:0:0:0:0:0:0:0:0:0:0:0:0:0:0:0:0:0:0:0:0:6:8:10:10:11:8:6:0:0:0:0
0:0:0:0:4:7:8:10:8:7:6:0:0:0:0:0:0:0:0:0:0:0:0:0:0:0:0:0:0:0:0:0:0:0:0:0:0:0:0:0:0:0:0:0:0:0:0:0:0:0:0:0:0:6:8:10:10:11:8:6:0:0:0:0
0:0:0:0:4:7:8:10:8:7:6:0:0:0:0:0:0:0:0:0:0:0:0:0:0:0:0:0:0:0:0:0:0:0:0:0:0:0:0:0:0:0:0:0:0:0:0:0:0:0:0:0:0:6:8:10:10:11:8:6:0:0:0:0
0:0:0:0:4:7:8:10:8:7:6:0:0:0:0:0:0:0:0:0:0:0:0:0:0:0:0:0:0:0:0:0:0:0:0:0:0:0:0:0:0:0:0:0:0:0:0:0:0:0:0:0:0:6:8:10:10:11:8:6:0:0:0:0
0:0:0:0:4:7:8:10:8:7:6:0:0:0:0:0:0:0:0:0:0:0:0:0:0:0:0:0:0:0:0:0:0:0:0:0:0:0:0:0:0:0:0:0:0:0:0:0:0:0:0:0:0:6:8:10:10:11:8:6:0:0:0:0
0:0:0:0:4:7:8:10:8:7:6:0:0:0:0:0:0:0:0:0:0:0:0:0:0:0:0:0:0:0:0:0:0:0:0:0:0:0:0:0:0:0:0:0:0:0:0:0:0:0:0:0:0:6:8:10:10:11:8:6:0:0:0:0
0:0:0:0:4:7:8:10:8:7:6:0:0:0:0:0:0:0:0:0:0:0:0:0:0:0:0:0:0:0:0:0:0:0:0:0:0:0:0:0:0:0:0:0:0:0:0:0:0:0:0:0:0:6:8:10:10:11:8:6:0:0:0:0
0:0:0:0:4:7:8:10:8:7:6:0:0:0:0:0:0:0:0:0:0:0:0:0:0:0:0:0:0:0:0:0:0:0:0:0:0:0:0:0:0:0:0:0:0:0:0:0:0:0:0:0:0:6:8:10:10:11:8:6:0:0:0:0
0:0:0:0:4:7:8:10:8:7:6:0:0:0:0:0:0:0:0:0:0:0:0:0:0:0:0:0:0:0:0:0:0:0:0:0:0:0:0:0:0:0:0:0:0:0:0:0:0:0:0:0:0:6:8:10:10:11:8:6:0:0:0:0
0:0:0:0:4:7:8:10:8:7:6:0:0:0:0:0:0:0:0:0:0:0:0:0:0:0:0:0:0:0:0:0:0:0:0:0:0:0:0:0:0:0:0:0:0:0:0:0:0:0:0:0:0:6:8:10:10:11:8:6:0:0:0:0
0:0:0:0:4:7:8:10:8:7:6:0:0:0:0:0:0:0:0:0:0:0:0:0:0:0:0:0:0:0:0:0:0:0:0:0:0:0:0:0:0:0:0:0:0:0:0:0:0:0:0:0:0:6:8:10:10:11:8:6:0:0:0:0
0:0:0:0:4:7:8:10:8:7:6:0:0:0:0:0:0:0:0:0:0:0:0:0:0:0:0:0:0:0:0:0:0:0:0:0:0:0:0:0:0:0:0:0:0:0:0:0:0:0:0:0:0:6:8:10:10:11:8:6:0:0:0:0
0:0:0:0:4:7:8:10:8:7:6:0:0:0:0:0:0:0:0:0:0:0:0:0:0:0:0:0:0:0:0:0:0:0:0:0:0:0:0:0:0:0:0:0:0:0:0:0:0:0:0:0:0:6:8:10:10:11:8:6:0:0:0:0
0:0:0:0:4:7:8:10:8:7:6:0:0:0:0:0:0:0:0:0:0:0:0:0:0:0:0:0:0:0:0:0:0:0:0:0:0:0:0:0:0:0:0:0:0:0:0:0:0:0:0:0:0:6:8:10:10:11:8:6:0:0:0:0
0:0:0:0:4:7:8:10:8:7:6:0:0:0:0:0:0:0:0:0:0:0:0:0:0:0:0:0:0:0:0:0:0:0:0:0:0:0:0:0:0:0:0:0:0:0:0:0:0:0:0:0:0:6:8:10:10:11:8:6:0:0:0:0
0:0:0:0:4:7:8:10:8:7:6:0:0:0:0:0:0:0:0:0:0:0:0:0:0:0:0:0:0:0:0:0:0:0:0:0:0:0:0:0:0:0:0:0:0:0:0:0:0:0:0:0:0:6:8:10:10:11:8:6:0:0:0:0
0:0:0:0:4:7:8:10:8:7:6:0:0:0:0:0:0:0:0:0:0:0:0:0:0:0:0:0:0:0:0:0:0:0:0:0:0:0:0:0:0:0:0:0:0:0:0:0:0:0:0:0:0:6:8:10:10:11:8:6:0:0:0:0
0:0:0:0:4:7:8:10:8:7:6:0:0:0:0:0:0:0:0:0:0:0:0:0:0:0:0:0:0:0:0:0:0:0:0:0:0:0:0:0:0:0:0:0:0:0:0:0:0:0:0:0:0:6:8:10:10:11:8:6:0:0:0:0
0:0:0:0:4:7:8:10:8:7:6:0:0:0:0:0:0:0:0:0:0:0:0:0:0:0:0:0:0:0:0:0:0:0:0:0:0:0:0:0:0:0:0:0:0:0:0:0:0:0:0:0:0:6:8:10:10:11:8:6:0:0:0:0
0:0:0:0:4:7:8:10:8:7:6:0:0:0:0:0:0:0:0:0:0:0:0:0:0:0:0:0:0:0:0:0:0:0:0:0:0:0:0:0:0:0:0:0:0:0:0:0:0:0:0:0:0:6:8:10:10:11:8:6:0:0:0:0
0:0:0:0:4:7:8:10:8:7:6:0:0:0:0:0:0:0:0:0:0:0:0:0:0:0:0:0:0:0:0:0:0:0:0:0:0:0:0:0:0:0:0:0:0:0:0:0:0:0:0:0:0:6:8:10:10:11:8:6:0:0:0:0
0:0:0:0:4:7:8:10:8:7:6:0:0:0:0:0:0:0:0:0:0:0:0:0:0:0:0:0:0:0:0:0:0:0:0:0:0:0:0:0:0:0:0:0:0:0:0:0:0:0:0:0:0:6:8:10:10:11:8:6:0:0:0:0
0:0:0:0:4:7:8:10:8:7:6:0:0:0:0:0:0:0:0:0:0:0:0:0:0:0:0:8:8:0:0:0:0:0:0:0:0:0:0:0:0:0:0:0:0:0:0:0:0:0:0:0:0:6:8:10:10:11:8:6:0:0:0:0
0:0:0:0:4:7:8:10:8:7:6:0:0:0:0:0:0:0:0:0:0:0:0:0:0:0:8:20:20:10:0:0:0:0:0:0:0:0:0:0:0:0:0:0:0:0:0:0:0:0:0:0:0:6:8:10:10:11:8:6:0:0:0:0
0:0:0:0:4:7:8:10:8:7:6:0:0:0:0:0:0:0:0:0:0:0:0:0:0:0:8:20:20:8:0:0:0:0:0:0:0:0:0:0:0:0:0:0:0:0:0:0:0:0:0:0:0:6:8:10:10:11:8:6:0:0:0:0
0:0:0:0:4:7:8:10:8:7:6:0:0:0:0:0:0:0:0:0:0:0:0:0:0:0:0:20:20:8:0:0:0:0:0:0:0:0:0:0:0:0:0:0:0:0:0:0:0:0:0:0:0:6:8:10:10:11:8:6:0:0:0:0
0:0:0:0:4:7:8:10:8:7:6:0:0:0:0:0:0:0:0:0:0:0:0:0:0:0:0:0:8:8:0:0:0:0:0:0:0:0:0:0:0:0:0:0:0:0:0:0:0:0:0:0:0:6:8:10:10:11:8:6:0:0:0:0
0:0:0:0:4:7:8:10:8:7:6:0:0:0:0:0:0:0:0:0:0:0:0:0:0:0:0:0:0:0:0:0:0:0:0:0:0:0:0:0:0:0:0:0:0:0:0:0:0:0:0:0:0:6:8:10:10:11:8:6:0:0:0:0
0:0:0:0:4:7:8:10:8:7:6:0:0:0:0:0:0:0:0:0:0:0:0:0:0:0:0:0:0:0:0:0:0:0:0:0:0:0:0:0:0:0:0:0:0:0:0:0:0:0:0:0:0:6:8:10:10:11:8:6:0:0:0:0
0:0:0:0:4:7:8:10:8:7:6:0:0:0:0:0:0:0:0:0:0:0:0:0:0:0:0:0:0:0:0:0:0:0:0:0:0:0:0:0:0:0:0:0:0:0:0:0:0:0:0:0:0:6:8:10:10:11:8:6:0:0:0:0
0:0:0:0:4:7:8:10:8:7:6:0:0:0:0:0:0:0:0:0:0:0:0:0:0:0:0:0:0:0:0:0:0:0:0:0:0:0:0:0:0:0:0:0:0:0:0:0:0:0:0:0:0:6:8:10:10:11:8:6:0:0:0:0
0:0:0:0:4:7:8:10:8:7:6:0:0:0:0:0:0:0:0:0:0:0:0:0:0:0:0:0:0:0:0:0:0:0:0:0:0:0:0:0:0:0:0:0:0:0:0:0:0:0:0:0:0:6:8:10:10:11:8:6:0:0:0:0
0:0:0:0:4:7:8:10:8:7:6:0:0:0:0:0:0:0:0:0:0:0:0:0:0:0:0:0:0:0:0:0:0:0:0:0:0:0:0:0:0:0:0:0:0:0:0:0:0:0:0:0:0:6:8:10:10:11:8:6:0:0:0:0
0:0:0:0:4:7:8:10:8:7:6:0:0:0:0:0:0:0:0:0:0:0:0:0:0:0:0:0:0:0:0:0:0:0:0:0:0:0:0:0:0:0:0:0:0:0:0:0:0:0:0:0:0:6:8:10:10:11:8:6:0:0:0:0
0:0:0:0:4:7:8:10:8:7:6:0:0:0:0:0:0:0:0:0:0:0:0:0:0:0:0:0:0:0:0:0:0:0:0:0:0:0:0:0:0:0:0:0:0:0:0:0:0:0:0:0:0:6:8:10:10:11:8:6:0:0:0:0
0:0:0:0:4:7:8:10:8:7:6:0:0:0:0:0:0:0:0:0:0:0:0:0:0:0:0:0:0:0:0:0:0:0:0:0:0:0:0:0:0:0:0:0:0:0:0:0:0:0:0:0:0:6:8:10:10:11:8:6:0:0:0:0
0:0:0:0:4:7:8:10:8:7:6:0:0:0:0:0:0:0:0:0:0:0:0:0:0:0:0:0:0:0:0:0:0:0:0:0:0:0:0:0:0:0:0:0:0:0:0:0:0:0:0:0:0:6:8:10:10:11:8:6:0:0:0:0
0:0:0:0:4:7:8:10:8:7:6:0:0:0:0:0:0:0:0:0:0:0:0:0:0:0:0:0:0:0:0:0:0:0:0:0:0:0:0:0:0:0:0:0:0:0:0:0:0:0:0:0:0:6:8:10:10:11:8:6:0:0:0:0
0:0:0:0:4:7:8:10:8:7:6:0:0:0:0:0:0:0:0:0:0:0:0:0:0:0:0:0:0:0:0:0:0:0:0:0:0:0:0:0:0:0:0:0:0:0:0:0:0:0:0:0:0:6:8:10:10:11:8:6:0:0:0:0
0:0:0:0:4:7:8:10:8:7:6:0:0:0:0:0:0:0:0:0:0:0:0:0:0:0:0:0:0:0:0:0:0:0:0:0:0:0:0:0:0:0:0:0:0:0:0:0:0:0:0:0:0:6:8:10:10:11:8:6:0:0:0:0
0:0:0:0:4:7:8:10:8:7:6:0:0:0:0:0:0:0:0:0:0:0:0:0:0:0:0:0:0:0:0:0:0:0:0:0:0:0:0:0:0:0:0:0:0:0:0:0:0:0:0:0:0:6:8:10:10:11:8:6:0:0:0:0
0:0:0:0:4:7:8:10:8:7:6:0:0:0:0:0:0:0:0:0:0:0:0:0:0:0:0:0:0:0:0:0:0:0:0:0:0:0:0:0:0:0:0:0:0:0:0:0:0:0:0:0:0:6:8:10:10:11:8:6:0:0:0:0
0:0:0:0:4:7:8:10:8:7:6:0:0:0:0:0:0:0:0:0:0:0:0:0:0:0:0:0:0:0:0:0:0:0:0:0:0:0:0:0:0:0:0:0:0:0:0:0:0:0:0:0:0:6:8:10:10:11:8:6:0:0:0:0
0:0:0:0:4:7:8:10:8:7:6:0:0:0:0:0:0:0:0:0:0:0:0:0:0:0:0:0:0:0:0:0:0:0:0:0:0:0:0:0:0:0:0:0:0:0:0:0:0:0:0:0:0:6:8:10:10:11:8:6:0:0:0:0
0:0:1:4:6:10:11:10:10:11:10:10:11:10:10:11:10:10:11:10:10:11:10:10:11:10:10:11:10:11:10:10:11:10:10:11:10:10:11:10:10:11:10:10:11:10:10:11:10:10:11:10:10:11:10:10:11:10:8:2:0:0:0:0
0:0:1:4:6:10:11:10:10:11:10:10:11:10:10:11:10:10:11:10:10:11:10:10:11:10:10:11:10:11:10:10:11:10:10:11:10:10:11:10:10:11:10:10:11:10:10:11:10:10:11:10:10:11:10:10:11:10:8:2:0:0:0:0
0:0:1:4:6:10:11:10:10:11:10:10:11:10:10:11:10:10:11:10:10:11:10:10:11:10:10:11:10:11:10:10:11:10:10:11:10:10:11:10:10:11:10:10:11:10:10:11:10:10:11:10:10:11:10:10:11:10:8:2:0:0:0:0
0:0:0:0:0:0:0:0:0:0:0:0:0:0:0:0:0:0:0:0:0:0:0:0:0:0:0:0:0:0:0:0:0:0:0:0:0:0:0:0:0:0:0:0:0:0:0:0:0:0:0:0:0:0:0:0:0:0:0:0:0:0:0:0
0:0:0:0:0:0:0:0:0:0:0:0:0:0:0:0:0:0:0:0:0:0:0:0:0:0:0:0:0:0:0:0:0:0:0:0:0:0:0:0:0:0:0:0:0:0:0:0:0:0:0:0:0:0:0:0:0:0:0:0:0:0:0:0
0:0:0:0:0:0:0:0:0:0:0:0:0:0:0:0:0:0:0:0:0:0:0:0:0:0:0:0:0:0:0:0:0:0:0:0:0:0:0:0:0:0:0:0:0:0:0:0:0:0:0:0:0:0:0:0:0:0:0:0:0:0:0:0
0:0:0:0:0:0:0:0:0:0:0:0:0:0:0:0:0:0:0:0:0:0:0:0:0:0:0:0:0:0:0:0:0:0:0:0:0:0:0:0:0:0:0:0:0:0:0:0:0:0:0:0:0:0:0:0:0:0:0:0:0:0:0:0
0:0:0:0:0:0:0:0:0:0:0:0:0:0:0:0:0:0:0:0:0:0:0:0:0:0:0:0:0:0:0:0:0:0:0:0:0:0:0:0:0:0:0:0:0:0:0:0:0:0:0:0:0:0:0:0:0:0:0:0:0:0:0:0
